['.', '.', '.', '.', '.', '.', '.', '.', '.', '.', '.', '.', '.', '.']
['.', '.', '.', '.', '.', '.', '.', '#', '.', '.', '.', '#', '.', '.']
['.', '.', '.', '.', '.', '.', '.', '.', '.', '.', '.', '.', '.', '.']
['.', '.', '#', '.', '.', '.', '.', '#', '.', '.', '.', '.', '.', '.']
['.', '.', '.', '.', '.', '.', '.', '.', '.', '.', '.', '.', '.', '.']
['.', '.', '#', '.', '.', '.', '.', '.', '.', '#', '.', '.', '.', '.']
['.', '.', '.', '.', '.', '.', '.', '.', '.', '.', '.', '.', '.', '.']
['.', '.', '.', '.', '.', '.', '.', '.', '.', '#', '.', '#', '.', '.']
['.', '.', '.', '.', '.', '.', '.', '.', '.', '.', '.', '.', '.', '.']
