['.', '.', '.', '.', '.', '.', '.', 'S', '.', '.', '.', '.', '.', '.', '.']
['.', '.', '.', '.', '.', '.', '|', '^', '|', '.', '.', '.', '.', '.', '.']
['.', '.', '.', '.', '.', '|', '^', '|', '^', '|', '.', '.', '.', '.', '.']
['.', '.', '.', '.', '|', '^', '|', '^', '|', '^', '|', '.', '.', '.', '.']
['.', '.', '.', '|', '^', '|', '^', '|', '|', '|', '^', '|', '.', '.', '.']
['.', '.', '|', '^', '|', '^', '|', '|', '|', '^', '|', '^', '|', '.', '.']
['.', '|', '^', '|', '|', '|', '^', '|', '|', '.', '|', '|', '^', '|', '.']
['|', '^', '|', '^', '|', '^', '|', '^', '|', '^', '|', '|', '|', '^', '|']
